もんだい	プロブレム	名詞
かだい	プロブレム	名詞
ぎもん	プロブレム	名詞
だかい	ブレーク	名詞
だは	ブレーク	名詞
とうろん	ブレーク	名詞
ぎろん	ディスカッション	名詞
とうろん	ディスカッション	名詞
いけん	オピニオン	名詞
しゅちょう	オピニオン	名詞
けんかい	オピニオン	名詞
りえき	プロフィット	名詞
しゅうえき	プロフィット	名詞
りじゅん	プロフィット	名詞
もうけ	プロフィット	名詞
うりあげ	プロフィット	名詞
りとく	プロフィット	名詞
べんえき	ベネフィット	名詞
おんけい	ベネフィット	名詞
こうよう	ベネフィット	名詞
りてん	アドバンテージ	名詞
べんぎ	アドバンテージ	名詞
きょうゆう	シェア	名詞
しじょう	シェア	名詞
うれしい	ハッピー	名詞
そうだい	ベリービッグ	名詞
ゆめ	ビジョン	名詞
もくひょう	ビジョン	名詞
ふんべつ	コモンセンス	名詞
しりょ	コモンセンス	名詞
りんり	コモンセンス	名詞
しゃかい	ソサエティー	名詞
せけん	ソサエティー	名詞
へんか	チェンジ	名詞
こうかん	チェンジ	名詞
かいぎ	ミーティング	名詞
ぎろん	ミーティング	名詞
なかま	メンバー	名詞
どうりょう	メンバー	名詞
いちいん	メンバー	名詞
ていけい	アライアンス	名詞
どうめい	アライアンス	名詞
しゅどう	イニシアチブ	名詞
そっせん	イニシアチブ	名詞
かくしん	イノベーション	名詞
ひようたいこうか	コスパ	名詞
とくよう	コスパ	名詞
ほうほう	メソッド	名詞
ほうしき	メソッド	名詞
しゅほう	メソッド	名詞
しゅだん	メソッド	名詞
とく	ウィンウィン	名詞
かんけい	コネクション	名詞
かんれん	コネクション	名詞
つながり	コネクション	名詞
かかわり	コネクション	名詞
せいりょくてき	アグレッシブ	名詞
こうげきてき	アグレッシブ	名詞
せっきょくてき	アグレッシブ	名詞
ていあん	サジェスト	名詞
しゃかい	ソーシャル	名詞
しゃこう	ソーシャル	名詞
ごうい	コンセンサス	名詞
けっか	リザルト	名詞
せいか	リザルト	名詞
いたく	コミットメント	名詞
かんよ	コミットメント	名詞
やくそく	コミットメント	名詞
こうやく	コミットメント	名詞
げんち	コミットメント	名詞
せきにん	コミットメント	名詞
さんか	コミットメント	名詞
ようぼう	アピアランス	名詞
がいけん	アピアランス	名詞
ふるまい	ビヘイビア	名詞
こうどう	ビヘイビア	名詞
おこない	ビヘイビア	名詞
たいど	ビヘイビア	名詞
きょどう	ビヘイビア	名詞
どうさ	ビヘイビア	名詞
ぎょうぎ	ビヘイビア	名詞
はんのう	ビヘイビア	名詞
さよう	ビヘイビア	名詞
ちょうし	ビヘイビア	名詞
くちたっしゃ	スムーズネス	名詞
くちじょうず	スムーズネス	名詞
なめらか	スムーズネス	名詞
えんかつ	スムーズネス	名詞
じょうほうでんたつ	コミュニケーション	名詞
でんたつ	コミュニケーション	名詞
いしそつう	コミュニケーション	名詞
そつう	コミュニケーション	名詞
こうりゅう	コミュニケーション	名詞
しんりがくてき	サイコロジカル	名詞
ひっす	マスト	名詞
じゅうよう	マスト	名詞
さいのう	ケイパビリティー	名詞
しゅわん	ケイパビリティー	名詞
のうりょく	ケイパビリティー	名詞
りきりょう	ケイパビリティー	名詞
とくいぶんや	コアコンピタンス	名詞
ちょうせん	チャレンジ	名詞
おもいだす	リマインド	名詞
よみがえる	リマインド	名詞
きかい	オポチュニティー	名詞
しゅんびん	アジャイル	名詞
すばやい	アジャイル	名詞
じじつ	ファクト	名詞
にゅうりょく	インプット	名詞
びんかん	センシティブ	名詞
ゆうせんじゅんい	プライオリティー	名詞
もくひょう	ミッション	名詞
もくてき	ミッション	名詞
のうりょく	アビリティー	名詞
ぎりょう	アビリティー	名詞
たっせい	クリア	名詞
かんりょう	クリア	名詞
しゅうりょう	クリア	名詞
しょうり	クリア	名詞
はっきりとした	クリア	名詞
はっきり	クリア	名詞
めいかく	クリア	名詞
みけってい	ペンディング	名詞
ほりゅう	ペンディング	名詞
よてい	アジェンダ	名詞
ぎだい	アジェンダ	名詞
にんめい	アサイン	名詞
わりあて	アサイン	名詞
かんたん	イージー	名詞
ようい	イージー	名詞
あんい	イージー	名詞
しんぽ	プログレスアップ	名詞
しんてん	プログレスアップ	名詞
かいぜん	プログレスアップ	名詞
おもいつき	ジャストアイディア	名詞
そんたく	ハイコンテクスト	名詞
できるだけはやく	ASAP	名詞
ようてん	サマリー	名詞
しゅし	サマリー	名詞
ようし	サマリー	名詞
かつどう	アクティビティー	名詞
かっき	アクティビティー	名詞
こうどう	アクティビティー	名詞
へんか	アクティビティー	名詞
そうぞう	イマジネーション	名詞
くうそう	イマジネーション	名詞
そうさく	イマジネーション	名詞
やること	TODO	名詞
やるべきこと	TODO	名詞
かてい	プロセス	名詞
こうてい	プロセス	名詞
ほうほう	プロセス	名詞
いけん	IMO	名詞
しゅかん	IMO	名詞
しゅちょう	IMO	名詞
せいかつようしき	ライフスタイル	名詞
かつどうか	インフルエンサー	名詞
こううん	ラッキー	名詞
いじょう	EOM	名詞
やくそく	アポ	名詞
とかいの	アーバン	名詞
ひとびと	ピーポー	名詞
ごうい	アグリー	名詞
うけとる	レシーブ	名詞
なる	ビカム	名詞
にんき	ポピュラー	名詞
ことば	ワード	名詞
じょうしき	コモンセンス	名詞
りえき	ベネフィット	名詞
しゅうえきか	マネタイズ	名詞
ゆうりな	アドバンテージ	名詞
ほうほう	メソッド	名詞
しくみ	メカニズム	名詞
べんり	コンビニエント	名詞
いきずまり	ボトルネック	名詞
りようしゃ	ユーザー	名詞
しみん	シティズン	名詞
じょうし	ボス	名詞
だいひょうとりしまりやく	CEO	名詞
きけん	リスク	名詞
しげん	リソース	名詞
こんきょ	リソース	名詞
しゅってん	リソース	名詞
きょうそう	コークリエーション	名詞
かくしん	イノベーション	名詞
たちあげ	ローンチ	名詞
どうき	モチベーション	名詞
えいきょう	ハレーション	名詞
かいわ	カンバセーション	名詞
はっけん	ディスカバリー	名詞
たいわ	ダイアログ	名詞
しょうとつ	コンフリクト	名詞
さいしゅうけってい	フィックス	名詞
だんかい	フェーズ	名詞
ゆうせんじゅんい	プライオリティ	名詞
ほりゅう	ペンディング	名詞
きかい	オポチュニティ	名詞
しゅうようのうりょく	キャパシティ	名詞
じっこう	パフォーマンス	名詞
ぼたい	マトリックス	名詞
しじょう	マーケット	名詞
しくみ	フレームワーク	名詞
けんきゅう	リサーチ	名詞
いきずまり	スタック	名詞
ほうこく	レポート	名詞
こうどう	アクション	名詞
ちかづく	アプローチ	名詞
ちかずく	アプローチ	名詞
がいぶいたく	アウトソージング	名詞
ぎょうむいたく	アウトソージング	名詞
いたく	アウトソージング	名詞
さんか	アテンド	名詞
しょきひよう	イニシャルコスト	名詞
ほうしゅう	インセンティブ	名詞
りょこうきゃく	インバウンド	名詞
りょこうきゃく	インバウンド	名詞
べんめい	エクスキューズ	名詞
いいわけ	エクスキューズ	名詞
いいぶん	エクスキューズ	名詞
とりつぎ	エスカレーション	名詞
ちょっき	NR	名詞
はたらきながらおぼえる	OJT	名詞
ていじ	オンスケ	名詞
たいしょうはんい	カバレッジ	名詞
へだたり	キャズム	名詞
きょりかん	キャズム	名詞
ようりょう	キャパシティ	名詞
しゅうようにんずう	キャパシティ	名詞
じょうほうしゅうしゅう	キュレーション	名詞
おきゃくさま	クライアント	名詞
こきゃく	クライアント	名詞
じゅうだい	クリティカル	名詞
ききてき	クリティカル	名詞
たいへん	クリティカル	名詞
ちめいてき	クリティカル	名詞
ひはんてき	クリティカル	名詞
おわり	クロージング	名詞
もくひょう	KGI	名詞
しょうひしゃ	コンシューマー	名詞
こうにゅうしゃ	コンシューマー	名詞
こうばいしゃ	コンシューマー	名詞
せいかりつ	コンバージョン	名詞
せいかりつ	CV	名詞
ほうりつ	コンプライアンス	名詞
ほうれい	コンプライアンス	名詞
だいさんしゃ	サードパーティー	名詞
じぞくかのう	サステナビリティ	名詞
そうじょうさよう	シナジー	名詞
そうじょうこうか	シナジー	名詞
かるいおもいつき	ジャストアイデア	名詞
げんしょう	シュリンク	名詞
ちぢむ	シュリンク	名詞
ちじむ	シュリンク	名詞
しゅくしょう	シュリンク	名詞
ふそく	ショート	名詞
ぎじゅつてきとくいてん	シンギュラリティ	名詞
けいかく	スキーム	名詞
せんべつ	スクリーニング	名詞
ふるいにかける	スクリーニング	名詞
はんい	スコープ	名詞
りがいかんけいしゃ	ステークホルダー	名詞
くわけしたもの	セグメント	名詞
くわけ	セグメンテーション	名詞
もくひょうせってい	ターゲティング	名詞
きびしい	タイト	名詞
たようせい	ダイバーシティ	名詞
ぎょうむ	タスク	名詞
しごと	タスク	名詞
けつだん	ディシジョン	名詞
はんだん	ディシジョン	名詞
でーたぶんせき	データマイニング	名詞
しめきり	デッドライン	名詞
しょきせってい	デフォルト	名詞
さいむふりこう	デフォルト	名詞
あべこべ	テレコ	名詞
はげます	ドライブ	名詞
ふるいたたせる	ドライブ	名詞
ゆうえきなじょうほう	ナレッジ	名詞
ふかかち	ナレッジ	名詞
ほとんどおなじ	ニアリーイコール	名詞
にている	ニアリーイコール	名詞
こくじ	ニアリーイコール	名詞
しじょうのすきま	ニッチ	名詞
じゅよう	ニーズ	名詞
こうしょう	ネゴ	名詞
せっしょう	ネゴ	名詞
こうしょう	ネゴシエーション	名詞
せっしょう	ネゴシエーション	名詞
ちしき	ノウハウ	名詞
ぎじゅつじょうほう	ノウハウ	名詞
つうち	ノーティス	名詞
こくち	ノーティス	名詞
ふりー	ノマド	名詞
しごとりょう	ノルマ	名詞
たっせいじょうけん	ノルマ	名詞
たっせいきじゅん	ノルマ	名詞
たっせいすいじゅん	ノルマ	名詞
よさん	バジェット	名詞
けいひ	バジェット	名詞
よびきかん	バッファ	名詞
もはん	パラダイム	名詞
てんけい	パラダイム	名詞
ほうじんびじねす	B to B	名詞
こじんびじねす	B to C	名詞
ひょうか	フィードバック	名詞
けってい	フィックス	名詞
だんかい	フェーズ	名詞
ゆうせんど	プライオリティ	名詞
ゆうせんじゅんい	プライオリティ	名詞
たかめる	ブラッシュアップ	名詞
よくする	ブラッシュアップ	名詞
せんでん	ブランディング	名詞
こうこく	ブランディング	名詞
どくせんじょう	ブルーオーシャン	名詞
アイデアを出し合う	ブレスト	名詞
アイデアを出し合う	ブレインストーミング	名詞
はえぬき	プロパー	名詞
せいきかかく	プロパー	名詞
せいきかかくひん	プロパー	名詞
せんでん	プロモーション	名詞
こうこく	プロモーション	名詞
ほうこう	ベクトル	名詞
ほうこうせい	ベクトル	名詞
ちゅうかいてすうりょう	マージン	名詞
はんばいてすうりょう	マージン	名詞
ふしめ	マイルストーン	名詞
だんかい	マイルストーン	名詞
かんがえかた	マインドセット	名詞
しこうたいど	マインドセット	名詞
たんとう	マター	名詞
しどうしゃ	メンター	名詞
じょげんしゃ	メンター	名詞
よりよい	モアベター	名詞
ぶひん	モジュール	名詞
りようたいけん	ユーザーエクスペリエンス	名詞
こきゃくたいけん	ユーザーエクスペリエンス	名詞
つかいやすさ	ユーザビリティー	名詞
こうよう	ユーティリティ	名詞
べんりなもの	ユーティリティ	名詞
はっちゅうからのうひんまでのじかん	リードタイム	名詞
きけんかいひ	リスクヘッジ	名詞
きそちしき	リテラシー	名詞
しんさーびすこうかい	ローンチ	名詞
はばひろいじゃんる	ロングテール	名詞
ながれ	ワークフロー	名詞
しごととせいかつのばらんす	ワークライフバランス	名詞
せいかつとしごとのばらんす	ワークライフバランス	名詞
おおく	モア	名詞
たくさん	モア	名詞
きたい	ホープ	名詞
こうしん	アップデート	名詞
せいげん	リミット	名詞
ひにち	デート	名詞
ひにち	デイ	名詞
じかん	タイム	名詞
ざんしん	パンチ	名詞
あたらしい	パンチ	名詞
かくしんてき	パンチ	名詞
ミーティング	MTG	名詞
かいぎ	MTG	名詞
ぎろん	MTG	名詞
すくないしりょう	ペライチ	名詞
いちまい	ペライチ	名詞
1まい	ペライチ	名詞
すこしだけ	ペライチ	名詞
ほうほう	モデル	名詞
しくみ	モデル	名詞
りえきをあげるしくみ	モデル	名詞
よてい	スケジュール	名詞
にってい	スケジュール	名詞
ひにち	スケジュール	名詞
せきにん	ボール	名詞
せきにんしゃ	ボール	名詞
たんとう	ボール	名詞
たんとうしゃ	ボール	名詞
じぜんちょうさ	フィジビリ	名詞
けんきゅう	フィジビリ	名詞
じぜんちょうさ	フィジビリティ	名詞
けんきゅう	フィジビリティ	名詞
じぜんちょうさ	フィジビリティー	名詞
けんきゅう	フィジビリティー	名詞
おわり	クロージング	名詞
しめくくり	クロージング	名詞
しゅうりょう	クロージング	名詞
でじたるぎじゅつのとりいれ	DX	名詞
でじたるぎじゅつをいれる	DX	名詞
でじたるぎじゅつをかつよう	DX	名詞
でじたるぎじゅつをつかう	DX	名詞
でじたるぎじゅつのとりいれ	デジタルトランスフォーメーション	名詞
でじたるぎじゅつをいれる	デジタルトランスフォーメーション	名詞
でじたるぎじゅつをかつよう	デジタルトランスフォーメーション	名詞
でじたるぎじゅつをつかう	デジタルトランスフォーメーション	名詞
でざいん	UI	名詞
ゆーざーいんたーふぇーす	UI	名詞
がいかん	UI	名詞
みため	UI	名詞
ゆーざーえくすぺりえんす	UX	名詞
おきゃくさまのたいけん	UX	名詞
おきゃくさまがかんじたこと	UX	名詞
だいれくとつーこんしゅーまー	D2C	名詞
ちょくせつとりひきをする	D2C	名詞
だいりてんをとおさない	D2C	名詞
こきゃくとちょくせつおこなう	D2C	名詞
もくひょうしすう	KPI	名詞
もくひょう	KPI	名詞
もくてき	KPI	名詞
KPIたっせいのためのしひょう	KGI	名詞
もくひょうしすうたっせいのためのしひょう	KGI	名詞
もくひょうたっせいのためのしひょう	KGI	名詞
もくてきたっせいのためのしひょう	KGI	名詞
ながれ	SIPOC	名詞
しごとのながれ	SIPOC	名詞
たすくかんりのふれーむわーく	SIPOC	名詞
ぷろじぇくとのためのふれーむわーく	SIPOC	名詞
